###################
#o       #x       #
#    #######      #
#    #            # 
#    #    #       #
#    #    #####   #
#         #x      #
###################

[8,20]
(1,1)
(10,1)|(11,6)
(0,0,20,1)
(0,1,1,6)
(9,1,1,1)
(19,1,1,6)
(5,2,7,1)
(6,3,1,3)
(6,3,1,3)
(10,4,1,3)
(10,5,5,1)
(0,7,20,1)